1111111111111111111111111111111111
100000000000000C10000C010000000001
1010010100100000101001110111110101
1110111110111110101111000100010101
101E00000C10C0000010000111000001C1
1P00000000100000001011110000000101
100000000010000E000000000000000101
1000000000100011111111111110000101
10000E00001000000000001C0000000101
10000C0000000000000000101111111101
10000000000000E0000000100000000001
1000011111111111110000000000010001
10000000000000C0000000000000010E01
1111111111111111111111111111111111
