11111111111111111111111
1E00E0000000000C0C00001
10100101001000001110101
10100100101010100110101
1P0000000C00C00E00000C1
11111111111111111111111
