1111111111111
1P01000000001
1000011111001
1000010001001
1000010000001
1000011111001
100C00E000001
1111111111111
1111111111111

