1111111111111
1P01C00000001
1000011111001
1000C1C001001
1000010000001
1000011111001
100C00E000C01
1111111111111
