11111111111111111111
100000000000000000E1
10000000000000000001
100000C000000C000001
10001000000000001001
10000100000000010001
10000011111111100001
1P000000000000000001
11111111111111111111
