1111111111111
1P01000C000C1
1000011111001
100001C001001
10CE010000001
1EEE0111110C1
1EEC00E000001
1111111111111
