1111111111111
1P01000C000C1
1000011111001
100001C001001
10C0010000001
10000111110C1
100C00E000001
1111111111111
